FOX Sports 502 AU|FoxLeague.au
FOX Sports 503 AU|FoxSports503.au
FOX Sports 504 AU|FoxFooty.au
FOX Sports 505 AU|FoxSports505.au
FOX Sports 506 AU|FoxSports506.au
FOX Sports 507 AU|FoxSportsMore.au
Fox Cricket|FoxCricket.au
beIN SPORTS Australia 1|beINSports1.au
beIN SPORTS Australia 2|beINSports2.au
beIN SPORTS Australia 3|beINSports3.au
CTV 2 Canada|CTV2.Toronto,.ON.ca
CTV Canada|CTV.(CFCN).Calgary,.AB.ca
Discovery Velocity CA|CTV.Speed.ca
Global CA|Global.BC.ca
Noovo CA|Noovo.(CFJP).Montreal,.QC.ca
RDS 2 CA|RDS2(src01).ca
RDS CA|RDS.(Réseau.des.sports).ca
RDS Info CA|RDS.Info.ca
Sportsnet 360|Sportsnet.360.ca
Sportsnet East|Sportsnet.(East).-.Satellite/Digital.ca
Sportsnet One|Sportsnet.One.ca
TSN1|TSN1.ca
TSN2|TSN2.ca
TSN3|TSN3.ca
TSN4|TSN4.ca
TSN5|TSN5.ca
TVA Sports|TVA.Sports.ca
TVA Sports 2|TVA.Sports.3.ca
TVO CA|TVO.(TV.Ontario).HD.ca
Sky Sport 1 NZ|Sky.Sport.1.nz
Sky Sport 2 NZ|Sky.Sport.2.nz
Sky Sport 3 NZ|Sky.Sport.3.nz
Sky Sport 4 NZ|Sky.Sport.4.nz
Sky Sport 5 NZ|Sky.Sport.5.nz
Sky Sport 6 NZ|Sky.Sport.6.nz
Sky Sport 7 NZ|Sky.Sport.7.nz
Sky Sport 8 NZ|Sky.Sport.8.nz
Sky Sport 9 NZ|Sky.Sport.9.nz
Sky Sport Select NZ|Sky.Sport.Select.nz
5 USA|5.USA.uk
BBC Four UK|BBC.Four.HD.uk
BBC One UK|BBCOne.uk
BBC Three UK|BBC.Three.HD.uk
BBC Two UK|BBC.Two.HD.uk
Channel 4 UK|Channel4.uk
Channel 5 UK|Channel.5.uk
Dave|Dave(src01).uk
E4 Channel|E4.HD.uk
EuroSport 1 UK|Eurosport.1.HD.uk
EuroSport 2 UK|Eurosport.2.HD.uk
Fashion TV|FashionTV(src01).uk
Film4 UK|Film4.HD.uk
Gold UK|GOLD(src01).uk
ITV 1 UK|ITV1.HD.uk
ITV 2 UK|ITV2.HD.uk
ITV 3 UK|ITV3.HD.uk
ITV 4 UK|ITV4.HD.uk
LaLigaTV UK|Sports.Dummy.us
Liverpool TV (LFC TV)|LFCTV.HD.uk
MTV UK|MTV.HD.uk
MUTV UK|MUTV.HD.uk
RTE 1|RTE1Network.uk
RTE 2|RTE2.uk
Racing Tv UK|Racing.TV.uk
S4C UK|S4C.uk
Sky Arts UK|Sky.Arts.HD.uk
Sky Atlantic|Sky.Atlantic.HD.uk
Sky Cinema Action UK|Sky.Action.uk
Sky Cinema Animation UK|SkyAnimationHD.uk
Sky Cinema Comedy UK|Sky.Comedy.Cinema.uk
Sky Cinema Drama UK|Sky.Drama.HD.uk
Sky Cinema Family UK|Sky.Family.HD.uk
Sky Cinema Greats UK|Sky.Greats.uk
Sky Cinema Hits UK|Sky.Cinema.Hits.HD.uk
Sky Cinema Premiere UK|Sky.Premiere.uk
Sky Cinema Sci-Fi Horror UK|Sky.ScFi/HorHD.uk
Sky Cinema Select UK|Sky.Cinema.Select.uk
Sky Cinema Thriller UK|Sky.Thriller.HD.uk
Sky Comedy UK|Sky.Comedy.HD.uk
Sky Crime|Sky.Crime.HD.uk
Sky History|Sky.HistoryHD.uk
Sky Showcase UK|Sky.Showcase.uk
Sky Sports Action UK|SkySp.Action.uk
Sky Sports Arena UK|SkySportsArena.uk
Sky Sports Cricket|SkySp.Cricket.uk
Sky Sports F1 UK|SkySp.F1.uk
Sky Sports Football UK|SkySp.Fball.uk
Sky Sports Golf UK|SkySp.Golf.uk
Sky Sports MIX UK|SkySp.Mix.HD.uk
Sky Sports Main Event|SkySpMainEv.uk
Sky Sports News UK|SkySp.News.HD.uk
Sky Sports Premier League|SkySportsPremierLeague.uk
Sky Sports Racing UK|SkySp.Racing.uk
Sky Sports Tennis UK|SkySp.Tennis.HD.uk
Sky Witness HD|Sky.Witness.HD.uk
TNT Sports 1 UK|TNT.Sports.1.HD.uk
TNT Sports 2 UK|TNT.Sports.2.HD.uk
TNT Sports 3 UK|TNT.Sports.3.HD.uk
TNT Sports 4 UK|TNT.Sports.4.HD.uk
Viaplay Sports 1 UK|Viaplay1(src01).uk
Viaplay Sports 2 UK|Viaplay2(src01).uk
Viaplay Xtra UK|ViaplayXtra.uk
A&E USA|A.and.E.US.-.Eastern.Feed.us
ABC (WSB-TV) USA|ABC.(WSB).Atlanta,.GA.us
ABC (WABC) USA|ABC.(WABC).New.York,.NY.us
ACC Network USA|ACC.Network.us
AMC USA|AMC.-.Eastern.Feed.us
AXS TV USA|AXS.TV.USA.HD.us
Adult Swim|Adult.Swim.-.East.HD.ca
Altitude Sports|Altitude.Sports.-.Denver.us
Animal Planet|Animal.Planet.US.-.East.us
BBC America (BBCA)|BBC.America.-.East.us
BBC News Channel HD|BBC.World.News.North.America.(BBCWN).us
BET USA|BET.-.Eastern.Feed.us
BIG TEN Network (BTN USA)|Big.Ten.Network.us
BeIN SPORTS USA|beINSports.us
Boomerang|Boomerang.us
Bravo USA|Bravo.USA.-.Eastern.Feed.us
C SPAN 1|C-SPAN.us
CBS Sports Golazo|Sports.Dummy.us
CBS Sports Network (CBSSN)|CBS.Sports.Network.USA.us
CBS (WWJ-TV) USA|CBS.(WWJ).Detroit,.MI.us
CBSNY USA|CBS.(WCBS).New.York,.NY.us
CMT USA|CMT.US.-.Eastern.Feed.us
CNBC USA|CNBC.USA.us
CNN USA|CNN.us
COZI TV USA|COZITV.us
CW PIX 11 USA|WPIX.New.York.(SUPERSTATION).us
CW (WUCW) USA|CW.(WUCW).St..Paul,.MN.us
Cartoon Network|Cartoon.Network.USA.-.Eastern.Feed.us
Cinemax USA|Cinemax.-.Eastern.Feed.us
Cleo TV|CleoTV.us
Comedy Central|Comedy.Central.(US).-.Eastern.Feed.us
Comet USA|Comet.TV.us
Cooking Channel USA|The.Cooking.Channel.us
Court TV USA|Court.TV.US.us
Crime+ Investigation USA|Crime.and.Investigation.Network.USA.HD.us
Destination America|Destination.America.us
Discovery Channel|Discovery.Channel.(US).-.Eastern.Feed.us
Discovery Family|Discovery.Family.Channel.us
Discovery Life Channel|Discovery.Life.Channel.us
Disney Channel|Disney.-.Eastern.Feed.us
Disney JR|Disney.Junior.USA.-.East.us
Disney XD|Disney.XD.USA.-.Eastern.Feed.us
E! Entertainment Television|E!.Entertainment.USA.-.Eastern.Feed.us
ESPN Deportes|ESPN.Deportes.us
ESPN USA|ESPN.us
ESPN2 USA|ESPN2.us
ESPNU USA|ESPN.U.us
ESPNews|ESPN.News.us
FETV - Family Entertainment Television|FETV.(Family.Entertainment.Television).us
FOX Deportes USA|Fox.Deportes.us
FOX Soccer Plus|FOX.Soccer.Plus.us
FOX (WFXT) USA|FOX.(WFXT).Boston,.MA.us
FOX (WNYW) USA|FOX.(WNYW).New.York,.NY.us
FUSE TV USA|FUSE.TV.-.Eastern.feed.us
FX Movie Channel|FX.Movie.Channel.us
FX USA|FX.Networks.East.Coast.us
FXX USA|FXX.USA.-.Eastern.us
FYI|FYI.USA.-.Eastern.us
FanDuel Sports Network Detroit|FanDuel.Sports.Network.Detroit.HD.us
FanDuel Sports Network Florida|FanDuel.Sports.Network.Florida.us
FanDuel Sports Network Great Lakes|FanDuel.Sports.Network.Great.Lakes.us
FanDuel Sports Network Indiana|FanDuel.Sports.Indiana.us
FanDuel Sports Network Midwest|FanDuel.Sports.Network.Midwest.St..Louis.us
FanDuel Sports Network North|FanDuel.Sports.Network.North.us
FanDuel Sports Network Ohio|FanDuel.Sports.Network.Ohio.-.Cleveland.us
FanDuel Sports Network Oklahoma|FanDuel.Sports.Network.Oklahoma.us
FanDuel Sports Network SoCal|FanDuel.Sports.Network.SoCal.us
FanDuel Sports Network South|FanDuel.Sports.Network.South.us
FanDuel Sports Network Southeast|FanDuel.Sports.Network.Southeast.us
FanDuel Sports Network Sun|Fanduel.Sports.Sun.us
FanDuel Sports Network West|FanDuel.Sports.Network.West.us
FanDuel Sports Network Wisconsin|FanDuel.Sports.Network.Wisconsin.us
Fight Network|The.Fight.Network.(United.States).(TFN).us
Fox Business|Fox.Business.us
Fox News|Fox.News.us
Fox Sports 1 USA|Fox.Sports.1.us
Fox Sports 2 USA|Fox.Sports.2.us
Fox Weather Channel|FOXWeather.us
Freeform|Freeform.-.East.Feed.us
GOLF Channel USA|Golf.Channel.USA.us
Galavisión USA|Galavision.-.Eastern.Feed.us
Game Show Network|Game.Show.Network.-.East.us
Great American Family Channel|Great.American.Family.us
Grit Channel|Grit.TV.us
HBO Comedy USA|HBO.Comedy.HD.-.East.us
HBO Family USA|HBO.Family.-.Eastern.Feed.us
HBO Latino USA|HBO.Latino.(HBO.7).-.Eastern.us
HBO Signature USA|HBO.Signature.(HBO.3).-.Eastern.us
HBO USA|HBO.-.Eastern.Feed.us
HBO Zone USA|HBO.Zone.HD.-.East.us
HBO2 USA|HBO.2.-.Eastern.Feed.us
HGTV|HGTV.USA.-.Eastern.Feed.us
Hallmark Movies & Mysteries|Hallmark.Mystery.Eastern.-.HD.us
Headline News|HLN.us
History USA|History.Channel.US.-.Eastern.Feed.us
IFC TV USA|IFC.HDTV.(East).us
ION USA|ION..-.Eastern.Feed.us
Investigation Discovery (ID USA)|Investigation.Discovery.USA.-.Eastern.us
Law & Crime Network|Law.and.Crime.us
Lifetime Movies Network|Lifetime.Movies.-.East.us
Lifetime Network|Lifetime.Network.US.-.Eastern.Feed.us
MASN USA|Mid-Atlantic.Sports.Network.us
MAVTV USA|MavTV.USA.us
METV USA|Me.TV.us
MGM+ USA / Epix|MGM+.HDTV.(East).(MGM+HD).us
MLB Network USA|MLB.Network.us
MSG USA|MSG.-.Syracuse.us
MSNBC|MSNBC.USA.us
MTV USA|MTV.USA.-.Eastern.Feed.us
MY9TV USA|MNT.(WWOR).New.York,.NY.us
Magnolia Network|Magnolia.-.East.us
Marquee Sports Network|Marquee.Sports.Network.us
Motor Trend|Motor.Trend.HD.us
NBA TV USA|NBA.TV.USA.us
NBC Sports Bay Area|NBC.Sports.Bay.Area.us
NBC Sports Boston|NBC.Sports.Boston.us
NBC Sports California|NBC.Sports.California.us
NBC Sports Philadelphia|NBC.Sports.Philadelphia.HDTV.(NBCSPAHD).us
Monumental Sports Network USA|Monumental.Sports.Network.us
NBC (WMAQ) USA|NBC.(WMAQ).Chicago,.IL.us
NBC (WCAU) USA|NBC.(WCAU).Philadelphia,.PA.us
NBC (WNBC) USA|NBC.(WNBC).New.York,.NY.us
NESN USA|New.England.Sports.Network.us
NFL Network|NFL.Network.us
NHL Network USA|NHL.Network.USA.us
NICK|Nickelodeon.USA.-.East.Feed.us
NICK JR|Nick.Jr..-.East.us
Nat Geo Wild USA|National.Geographic.Wild.us
National Geographic (NGC)|National.Geographic.US.-.Eastern.us
NewsNation USA|NewsNation.-.Eastern.Feed.us
Newsmax USA|NewsMax.TV.us
Nick Music|Nick.Music.(NICM).us
Nicktoons|Nicktoons.-.East.us
Oprah Winfrey Network (OWN)|Oprah.Winfrey.Network.USA.Eastern.us
Oxygen True Crime|Oxygen.-.Eastern.Feed.us
PDC TV|Darts.Dummy.us
POP TV USA|POP.-.East.us
Pac-12 Network USA|Sports.Dummy.us
Paramount Network|Paramount.Network.USA.-.Eastern.Feed.us
Reelz Channel|ReelzChannel.us
Root Sports Northwest|Root.Sports.Northwest.us
SEC Network USA|SEC.Network.us
SYFY USA|Syfy.-.Eastern.Feed.us
Science Channel|Science.us
Showtime 2 USA (SHO2) USA|Showtime.2.-.Eastern.us
Showtime Extreme USA|Showtime.Extreme.-.Eastern.us
Showtime Family Zone (SHO Family Zone) USA|Showtime.FamilyZone.(East).(SHOFe).us
Showtime Next (SHO Next) USA|Showtime.Next.HD.-.Eastern.us
Showtime Showcase USA|Showtime.Showcase.HD.-.East.us
Showtime USA|Paramount+.with.Showtime.-.Eastern.Feed.us
Smithsonian Channel|Smithsonian.Channel.USA.HD.us
Space City Home Network|Space.City.Home.Network.us
Spectrum Sportsnet LA|Spectrum.Sportsnet.Lakers.us
SportsNet New York (SNY)|SNY:.SportsNet.New.York.(Comcast).us
SportsNet Pittsburgh|SportsNet.Pittsburgh.us
Sportsnet Ontario|Sportsnet.(Ontario).ca
Sportsnet West|Sportsnet.(West).-.Satellite/Digital.ca
Sportsnet World|Sportsnet.World.ca
Starz|Starz.-.Eastern.us
Sundance TV|SundanceTV.USA.-.East.us
TBS USA|TBS.-.East.us
TCM USA|Turner.Classic.Movies.USA.us
TLC|TLC.USA.-.Eastern.us
TMC Channel USA|TMC.(US).-.Eastern.Feed.us
TNT USA|TNT.-.Eastern.Feed.us
TUDN USA|TUDN.us
TV ONE USA|TV.One.us
TVLAND|TV.Land.-.Eastern.us
TeenNick|TeenNick.-.Eastern.us
Telemundo|Telemundo..-.Eastern.Feed.us
Tennis Channel|The.Tennis.Channel.us
The Food Network|Food.Network.USA.-.Eastern.Feed.us
The Hallmark|Hallmark.-.Eastern.Feed.us
The Weather Channel|The.Weather.Channel.us
Travel Channel|TheTravelChannel.us
TruTV USA|truTV.USA.-.Eastern.us
USA Network|USA.Network.-.East.Feed.us
Unimas|UniMás..-.Network.Pacific.us
Univision|Univision.-.Eastern.Feed.us
VH1 USA|VH1.-.Eastern.Feed.us
VICE TV|VICE.us
WETV USA|WE.(Women&apos;s.Entertainment).-.Eastern.us
WWE Network|WWE.Network.us
Willow Cricket|Willow.Cricket.HDTV.(WILLOWHD).us
Willow XTRA|Willow.Xtra.us
YES Network USA|YES.Network.us
